4
#############################
#...........................#
#.......................D...#
y@..........................#
y...........................#
#...........................#
#...........................#
#############################