0
#######
#...#.#
#.#.#.x
#.#...#
#.#.#.#
#@#.#.#
#######